 111111111111
   111111   1
1   12 1    1
1           1
1           1
1111    11111
